limm -- 363 - pap

augesco - excandesco - in· ceps cel caput daemonum -
valesce - inratec - praevaleo calumniator.
· isslssssdOl'· {lmmm'lrmqum‘lr - 'dulc - 'lrm3
{lmumqmqurr (adv). (ῙΠΓῙῑθΓ - Ummm‘drmdmurlr
aspere - severe - fortiter · diabolicus - tartareus.
grauiter - vehementer. llmmmnmdaepptt-fillmie·dae-
llmumpmpeugmtts-pntpp·cor· monis artes · perversitas ··
roboro - roboro - augeo - scelus.
iortificc - lirmo. llmmmp.p[·-pmp·operarius-
{lmampmplpe‘u - primia· rehe— lactucas - agricola -rusticus
mentia - uiolentia - durities - cooperator - adiutor - au·
- severitudo - incrementum uitiator - opitulator.
- tortitudo - robur - aug· llmmmptrr- epp· auxilior - u-
mentum. pitulor - succurro - subve-
θ ηωυιιιᾷηιβῦιυῆὲ (adv). (lll- ΗῘΟ ·· SithidiO vellit) ¹· ad-
rius - severe - vehementer iuro.
- uiolenter. llmmmpeepllla'a - [dimis- auxi·
llwmmlis- bpln subverto - a· lium · opitulatio - subsidium
verto -, vasto - aufero - con- - adiutorium - cooperatio -
sumo - noceo - extermiuo opus.
- perdo - trucido - interli- llmmdp - pl· - 1va (praec).
cio - occido - corrumpo - limas· - mlp -mtpp nummus
dissolvo - tullo. · quatuor drachmis aequalis -
llmmwllvs-lbpmp·pereo-ccu— stater.
sumar - exspiro - morior. {lurp - [up · pop vel - pp - [ψῃ
ΗΨΜΨΗἎ· Μ’ · stuta· SUbVOI'· vel - pun-[rutae apex ⁸· Vellei(
scr - eversor - uastatur -· - culmen - cacumen -· la-
extermiuatcr - interlector - stipium ·· summurn - pro·
occisor - perditor. ¹ montorium - instrumentum
{tumulando - larmir· eversio - - vasa - supellex - orua-
vastatio ·- perditio - exter· mentum -apparatus -arma
minium - trucidatio -iuter- llwpml - ll· - lup· monticellus
lectio - interitus - interitio - monticulus - collis - cli·
- occisio - strages - caedes. vus - clivulus.
{lmurm‘lr “¹¹‘' vel Umprmu · ull (ι carrd) - “l'ff‘ mo-
llmmmnmd -Jlu dus - ratio - torma - habitus.
diabulus - satanas - daemo- llwpmwiip · pl· - μθ

uium - cacodaemou - priu— llmfmennqnp . Μ. . pap ΡΜ·

adversarius -

 

